126s 6d
WWWWWWWWWWWWW
WXXXXXXXXGGGW
WDGDGGGGGGGBW
WGDG.DDD.GBGW
WGGGGBGGBGB.W
WBGGBBGGGBGGW
WGEGBGGRGB.GW
WGGGBBGGGB.GW
WGGGGBGGGGGGW
WWWWWWWWWWWWW