126s 10d
WWWWWWWWWWWWWEW
WGBGDDDDDDDWDBW
WGGGGGGGGGGWBGW
WGGGGGGGGGGWG.W
WRGGGGBGGG.W.BW
WWWWWWWWGWWW.GW
WDBGGGBGGGGG.GW
WDGGBGGGGGB..GW
WWWWWWWWWWWWWWW