120s 4d
WWWWWWWWWWW
WR....GG.BW
W..BGGDG..W
W.DGGDGG..W
W...GGD...W
W.B.GGGG..W
W........EW
WWWWWWWWWWW