150s 1d
WWWWWWWWWWWWWWWWWWWWWWWWWWWW
WGGBBBGGGGGGGGGGGGGGGGGGGGGW
WGG...GGGGGGGGGGGGGGGGGGGGGW
WGGBBBGGGGGGGGGGBGGGGGGGGGGW
WGG...GGGGGGGGGGBGGGGGGGGGGW
WGG........GGGGGBGGGGGGGGGGW
WGG........GGGGGGGGGGGGGGGGW
WGG...R....GGGGGGGGGGGGGBGGW
WGG........GGGGGGGGGGGGGDGGW
WGG........GEGGGGGGGGGGGGGGW
WWWWWWWWWWWWWWWWWWWWWWWWWWWW