126s 1d
WWWWWW
W..D.W
W....W
WR..EW
WWWWWW