126s 6d
WWWWWWWWWWWW
WGBGDDDDDDXW
WGGGGGGGGGGW
WGGGGGGGGGGW
WRGGGGBGGGEW
WWWWWWWWWWWW