41s 3d
WWWWWWWWWW
WXXXXXXXXW
WDGDGGGGGW
WGDG.GGG.W
WGGGGBGGBW
WBGGGBGGGW
WGEGGGGRGW
WWWWWWWWWW
