180s 4d
WWWWWWWWWWWWWWWWWWWWWWWWWWWWWWWWWWWWWWWWWWWWWWWWWW
WGGGGGGGGGGGGGWGGGGGGGGGGGGGGGGGGGGGGGGGGGGGGGGGGG
WGGGGGGGGGGGGGWGGGGGGGGGGGGGGGGGGGGGGGGGGGGGGGGGGG
WGGGGGGGGGGGGGWGGGGGGGGGGGGGGGGGGGGG....GGGGGGGGGG
WGGGGGGGGGGGGGWGGGGGGGGGGGGGGGGGBGGGWWWWGGGGGGGGGG
WGGGGGGGBGGGGGWGGGGGGGGGGGGGGGGGBGGGWWWWGGGGGGGGGG
WGGGGGGGBGGGGGWGGGGGGBGGGGGGGGGGBGGGWWWWGGGGGGGGGG
WGGGGGGGBGGGGGWGGGGGGBGGGGGGGGGGBGGGWWWWGGGGGGGGGG
WGGGGGGGBGGGGGWGGGGGGBGGGGGGGGGGBGGGWWWWGGGGGGGGGG
WGGGGGGGBGGGGGWGGGGGGBGGGGGGGGGGBGGGWWWWGGGGGGGGGG
WGGGGGGGBGGGGGWGGGGGGBGGGGGGGGGGBGGGWWWWGGGGGGGGGG
WGGGGGGBBGGGGGWGGGGGGBGGGGGGGGGGBGGGWWWWGGGGGGGGGG
WGGGGGGBBGGGGGWGGGGGGDGGGGGGGGGGGGGGWWWWGGGGGGGGGG
WGGGGGGBBGGGGGWGGGGGGGGGGGGGGGGGGGGGWWWWGGGGGGGGGG
WGGGGGBBBGGGGGWGGGGGGGGGGBBBGGGGGGGGWWWWGGG.....GG
WGGGGGBGGGRGGGWGGGGGGGGGGGDGGGGGGGGGWWWWGGG.....GG
WGGGGGBGBBBBBBWBBBBGGGGGGGDGGGGGGGGGWWWWGGG...E.GG
WGGGGGBGGGGGGGGGGGGGGGGGGGGGGGGGGGGGWWWWGGG.....GG
WGGGGGDGGGGGGGGGGGGGGGGGGGGGGGGGGGGGWWWWGGGGGGGGGG
WWWWWWWWWWWWWWWWWWWWWWWWWWWWWWWWWWWWWWWWWWWWWWWWWW