150s 4d
WWWWWWWWWWWWWW
WGGGGGG.GGDGBW
WDBRBGGGGGGGXW
WGGGGGGGGG..GW
WBGBBGGDGGGGGW
WGG.BGGGGGGGGW
WGDG.GG.GGGGEW
WWWWWWWWWWWWWW
