150s 0d
WWWWWWWWWWWWWWW
WGGGGGGGGGG.GGW
WGGGGGGGGG.RGGW
WGGBGGGGGGGGGGW
WGGBGGGG..GGGGW
WGGBGGGBBBGGGGW
WGGBGGGGGGGGGGW
WGGBGGGDGGGGGGW
WGGBGGGGGGGGGGW
WGGGGGGGG.GGGGW
WGGEGGGGGGGGGGW
WWWWWWWWWWWWWWW