150s 4d
WWWWWWWWWWWWWW
WGGGGGG.GGDGBW
WDBRBGGGGGG.GW
WGGGGGGGGGG.GW
WBGBBGGDGGGGGW
WGG.BGGGGGGGGW
WGDG.GG.GGGGEW
WWWWWWWWWWWWWW
