20s 1d
WWWWWWWWWW
WGGGGGGGGW
WGGGGGRGGW
WGG.GGGGGW
WGGBGGDGGW
WGGGGGGGGW
WGGGGGEGGW
WWWWWWWWWW