126s 3d
WWWWWWWWWWWWW
WXXXXXXXXGGGW
WDGDGGGGGGGGW
WGDG.GGG.GGGW
WGGGGBGGBGG.W
WBGGGBGGGGGGW
WGEGGGGRGG.GW
WGGGGGGGGG.GW
WGGGGGGGGGGGW
WWWWWWWWWWWWW