41s 3d
WWWWWWWWWW
WGGGGGGGGW
WDGDGGGGGW
WGDG.GGG.W
WGGGGBGGBW
WBGGGBGGGW
WGEGGGGRGW
WWWWWWWWWW