126s 7d
WWWWWWWWWWWWWWWWWWWW
WGGDGGGGGWGGGGGGGGGW
WGBGBGGGGWGBBGDDGBBW
WRGGGBGBGDGGGBGGGGGW
WGGGBGBGGGGGGGGGGGGW
WBGGGGGGWWWWWWWWWWWW
WGGGDGGGWGGGGGGGGBGW
WGGBGGGGGGGGGGBGBGGW
WWWWWWWWWWWWWGGGGGGW
WGBGBBGGGBGGGGGGGGGW
WEDGGGGGGGGGGWGGGGDW
WWWWWWWWWWWWWWWWWWWW