150s 17d
WWWWWWWWWWWWWW
WXDDDDDDDDD..W
W...BBBBBBB..W
W...BBBBBB...W
W...BBBB.....W
W...BB.......W
W............W
WR...........W
W............W
W...DDDDDDDDEW
WWWWWWWWWWWWWW