100s 9d
WWWWWWWWWWWWW
W.GD..BBBBG.W
WGGDDD.X....W
WE.DGDG..GG.W
WGGDG.DGG...W
W.GG.DGG..R.W
W..GGG......W
WWWWWWWWWWWWW